20
20
0 0 0 0 0 0 0 0 0 0 0 0 4 5 4 0 0 0 4 6 
0 0 0 0 0 0 0 0 0 0 0 0 0 4 0 0 0 0 0 4 
1 0 0 0 0 0 0 0 0 0 0 0 0 0 0 0 0 0 0 1 
1 1 4 1 0 0 0 0 0 0 0 0 0 0 0 1 1 1 1 1 
1 4 7 4 1 1 1 1 1 1 1 1 1 1 1 1 1 1 1 1 
1 1 4 1 1 1 1 1 1 1 1 1 1 1 1 1 1 1 1 1 
2 2 2 1 1 1 1 1 1 1 1 1 1 1 1 1 1 1 2 2 
2 2 2 2 2 2 2 2 2 2 2 2 2 2 4 2 2 2 2 2 
2 2 2 2 2 2 2 2 2 2 2 2 2 4 5 4 2 2 2 2 
3 3 2 2 2 2 2 2 2 2 2 2 2 2 4 4 2 2 2 2 
3 3 3 3 3 3 3 2 2 2 4 2 2 2 4 5 4 3 3 3 
3 3 3 3 3 3 3 3 3 4 7 4 3 3 3 4 3 3 3 3 
3 3 3 3 3 3 3 3 3 4 4 3 3 3 3 3 3 3 3 3 
3 3 3 3 3 3 3 3 4 6 7 4 3 3 3 3 3 3 3 3 
3 3 3 3 3 3 3 3 3 4 4 3 3 3 3 3 3 3 3 3 
3 3 3 3 3 3 3 3 3 3 3 3 3 3 3 3 3 3 3 3 
3 3 3 3 3 3 3 3 3 3 3 3 3 3 3 4 3 3 3 3 
3 3 3 3 3 3 3 3 3 3 3 3 3 3 4 6 4 3 3 3 
3 3 3 3 3 3 3 3 3 3 3 3 3 3 3 4 3 3 3 3 
3 3 3 3 3 3 3 3 3 3 3 3 3 3 3 3 3 3 3 3 
#ENDTERRAIN
13 320 256
8 576 832
11 576 704
11 576 768
10 576 640
10 576 576
10 576 576
10 576 512
10 576 448
10 576 384
10 576 384
10 576 320
10 576 256
12 384 256
10 448 256
10 512 256
8 640 704
11 640 640
8 640 832
11 704 832
10 768 832
10 768 768
10 768 704
10 768 640
10 768 576
10 768 512
10 704 512
10 640 512
10 896 384
10 960 384
10 960 448
10 896 448
10 768 448
10 768 448
10 832 448
10 768 512
10 1024 448
10 1024 384
10 1024 512
10 960 512
10 896 512
10 832 512
10 768 512
10 768 512
#ENDUSERBUILD