20
20
0 0 0 0 0 0 0 0 0 0 0 0 4 5 4 0 0 0 4 6 
0 0 0 0 0 0 0 0 0 0 0 0 0 4 0 0 0 0 0 4 
1 0 0 0 0 0 0 0 0 0 0 0 0 0 0 0 0 0 0 1 
1 1 4 1 0 0 0 0 0 0 0 0 0 0 0 1 1 1 1 1 
1 4 7 4 1 1 1 1 1 1 1 1 1 1 1 1 1 1 1 1 
1 1 4 1 1 1 1 1 1 1 1 1 1 1 1 1 1 1 1 1 
2 2 2 1 1 1 1 1 1 1 1 1 1 1 1 1 1 1 2 2 
2 2 2 2 2 2 2 2 2 2 2 2 2 2 4 2 2 2 2 2 
2 2 2 2 2 2 2 2 2 2 2 2 2 4 5 4 2 2 2 2 
3 3 2 2 2 2 2 2 2 2 2 2 2 2 4 4 2 2 2 2 
3 3 3 3 3 3 3 2 2 2 4 2 2 2 4 5 4 3 3 3 
3 3 3 3 3 3 3 3 3 4 7 4 3 3 3 4 3 3 3 3 
3 3 3 3 3 3 3 3 3 4 4 3 3 3 3 3 3 3 3 3 
3 3 3 3 3 3 3 3 4 6 7 4 3 3 3 3 3 3 3 3 
3 3 3 3 3 3 3 3 3 4 4 3 3 3 3 3 3 3 3 3 
3 3 3 3 3 3 3 3 3 3 3 3 3 3 3 3 3 3 3 3 
3 3 3 3 3 3 3 3 3 3 3 3 3 3 3 4 3 3 3 3 
3 3 3 3 3 3 3 3 3 3 3 3 3 3 4 6 4 3 3 3 
3 3 3 3 3 3 3 3 3 3 3 3 3 3 3 4 3 3 3 3 
3 3 3 3 3 3 3 3 3 3 3 3 3 3 3 3 3 3 3 3 
#ENDTERRAIN
8 128 256
12 128 64
11 128 192
10 128 128
13 128 0
11 192 0
#ENDUSERBUILD